          NO      imgs/wall1.xpm          

                          SO           imgs/wall2.xpm

   F 150,50,100
                  C 250,150,200


  WE imgs/wall3.xpm      

   EA            imgs/wall4.xpm
   


             11111
  1111111              111111111111
  10N001         1111111111111111111
   11111      1111111111111111111111111111
   11      1111011000000000001111
111111111111110001110000000001111111
100000011111111111111111111111111111
10000001111111111111111111111
11110111111111011100000010001   111
1111011111111101110101001001    111
1100000011010101110000100001    111
1000000000000001100000010011
10000000100000001001100000111
11110111 1110101 101111010001
11111111 1111111 11111111111
