NO imgs/wall1.xpm

SO imgs/wall2.xpm

WE imgs/wall3.xpm

EA imgs/wall4.xpm

F 150,50,100

C 250,150,200

1111111111111111111111111111111111111111111111111111111111111111111111111111111
1000000000000000001000000000000000000000000000000000000000000000000000000000101
1000010000000000001000000000000000000000000000000000000000000000000000000001011
1111000000000000000000000000000000000000000000000000000000000000000000000101011
1000000000000000001000000000000000000000000000000000000000000000000000000101011
1111100111111111111000000000000000000000000000000000000000000000000000011111011
10000000000000000010000000000000000000000000000000000N0000000000000000000000011
1000011000000000001000000000000000000000000000000000000000000000000000000000011
1111110000000000001000000000000000000000000000000000000000000000000000001111011
1000000000000000001000000000000000000000000000000000000000000000000000000000011
1111111110000000001000000000000000000000000000000000000000000000000000000000111
        11000000000011111111111111111111111111111111111111111111111111111111111
        10000000000001
        110000000000111
        11000000000011
        11000000000011
        1100000000011
        1100000000011
      11100000000001
    1100000000000111
1111111000000001011
100001000000101111
111100000010101
100000000010101
100000001111101
100000000000001
100000000000001
111111000111101
100000000000001
111111111111111
