NO imgs/redbrick.xpm

SO imgs/greystone.xpm

WE imgs/eagle.xpm

EA imgs/wood.xpm

C 200,200,200

F 22,20,21

1111111111111111111111
1000000000000000000001
1000010000000000000001
1111000000000000000001
1000000000000000000001
1111111111000000111111
10000000000000N0000001
1000011000000000000001
1111110000000000000001
1000000000000000000001
1111111110000000000001
        11000000001111
        10000000000001
        110000000000111
         100000000001
         1000000000011
        1100000000011
        1100000000011
      11100000000001
    1100000000000111
111111100000000101
100001000000101111
111100000010101
100000000010101
100000001111101
100000000000001
100000000000001
111111000111101
100000000000001
111111111111111
